employer,top,Data Analyst,Data Engineer,Data scientist,total
23andMe,0,0,1,0,1
"3Derm Systems, Inc.",0,0,0,1,1
3M,0,0,2,4,6
3T Biosciences,0,0,0,4,4
4D MOLECULAR THERAPEUTICS,0,0,0,1,1
84.51°,0,0,0,1,1
"A. Schulman, Inc.",0,0,1,0,1
"A2Z Development Center, Inc.",0,0,3,3,6
AAA Northeast,0,1,0,0,1
ABB,0,0,0,1,1
Abbott Laboratories,0,2,2,2,6
AbbVie,0,0,0,1,1
Absolute Software,0,0,1,1,2
Acacia Communications,0,0,2,0,2
Accelerate Diagnostics Inc.,0,0,0,1,1
AccessLex Institute,0,0,0,1,1
Accudyne Industries,0,0,1,0,1
ACI Federal™,0,0,0,1,1
Action Against Hunger,0,0,0,1,1
Acuity Brands,0,0,1,0,1
Acumen LLC,0,1,1,0,2
acumenllc,0,1,1,1,3
ADP,0,1,0,1,2
Advance America,0,0,1,0,1
Advanced Monolithic Systems,0,0,1,0,1
Advanced Technology International,0,0,1,0,1
AdvanSix INC,0,1,0,0,1
Advantage Solutions,0,1,0,5,6
"Advantasure, Inc.",0,11,0,1,12
AdventHealth,0,1,0,2,3
AdventHealth Corporate,0,0,0,1,1
AdventHealth Greater Orlando,0,1,0,2,3
Adventist Health St. Helena,0,1,0,0,1
Advisor Group,0,1,0,0,1
"AE & Associates, LLC",0,1,0,0,1
AECOM,0,0,2,4,6
AEG,0,0,0,1,1
AETNA,0,3,3,6,12
AGCO,0,0,2,0,2
AGEISS Inc.,0,0,1,0,1
Agero,0,0,1,1,2
"Agilent Technologies, Inc.",0,0,0,3,3
AIA Chicago,0,0,1,0,1
Air Liquide,0,0,0,3,3
Airgas Inc.,0,1,0,0,1
Akamai,0,0,1,0,1
Akraya Inc.,0,5,2,2,9
Alaka`ina Foundation Family of Companies,0,1,0,1,2
Alaska Airlines,0,1,0,2,3
Albert Einstein College of Medicine,0,0,0,1,1
Albertsons Companies,0,1,0,1,2
Alchemy Software Solutions,0,0,0,1,1
ALCORA Corporation,0,0,0,1,1
Aldevron,0,0,0,1,1
Aledade,0,1,0,0,1
Alerus Financial,0,2,0,0,2
"Alexion Pharmaceuticals,Inc.",0,0,0,1,1
ALICE OLIVIA,0,0,0,1,1
"Alkermes, Inc.",0,2,0,0,2
Allegiant Travel Company,0,2,0,0,2
Alliance Data - Retail,0,1,0,0,1
Alliance Residential,0,1,0,0,1
Alliant Insurance Services,0,1,0,1,2
Allina Health,0,0,0,1,1
Allscripts,0,0,1,0,1
Allstate,0,0,4,3,7
ALS,0,0,0,1,1
ALS Group,0,0,0,1,1
AltaMed,0,0,1,0,1
AM Pierce & Associates,0,1,0,0,1
"Amches, Inc.",0,0,0,1,1
Amegy Bank of Texas,0,1,0,0,1
American Agricultural Insurance Company,0,1,0,0,1
American College of Cardiology (ACC),0,1,0,0,1
American Electric Power,0,0,1,0,1
American Express,0,3,0,0,3
American National Family of Companies,0,0,1,2,3
American National Insurance Company,0,0,1,2,3
American Physical Society,0,0,0,1,1
AMERICAN SYSTEMS,0,5,0,0,5
American Vision Partners,0,1,0,0,1
AmeriCorps,0,1,0,0,1
AmeriHealth Caritas,0,1,1,0,2
Ameriprise Financial,0,0,1,0,1
AmerisourceBergen,0,1,0,1,2
Amgen,0,2,0,3,5
Amobee,0,0,0,1,1
Amplifon,0,0,0,2,2
Analog Devices,0,0,1,0,1
ANALYTOS,0,0,0,3,3
Annapurna Labs (U.S.) Inc.,0,0,1,0,1
Ansira,0,0,0,1,1
AnswerRocket,0,1,2,2,5
"Anthem, Inc.",0,1,0,1,2
Apergy,0,0,1,0,1
APL Logistics,0,1,0,0,1
Applause,0,0,1,0,1
APPLICATIONS DIVISION,0,0,0,1,1
Applied Materials Inc.,0,0,0,2,2
"Applied Medical Technology, Inc.",0,0,1,0,1
"Applied Research Associates, Inc",0,0,0,1,1
Applied Systems Inc.,0,0,0,2,2
Aquabyte,0,0,1,0,1
Aramark,0,3,1,0,4
Arc Aspicio,0,2,0,1,3
Ardent Health Services,0,1,0,0,1
Arjo,0,0,1,0,1
Arkansas Blue Cross and Blue Shield,0,1,0,0,1
Arkansas Department of Human Services,0,1,0,1,2
"Arrow Electronics, Inc.",0,0,1,1,2
Aruba Networks,0,0,1,0,1
Arundo Analytics,0,0,0,1,1
ARUP Laboratories,0,0,0,1,1
Ascension System Office,0,1,0,0,1
"Ascension, WI",0,0,0,2,2
Ascolta,0,0,0,1,1
ASRC Federal Holding Company,0,0,1,0,1
Assemblix LLC,0,0,1,0,1
Assurant,0,0,0,2,2
AstraZeneca,0,0,0,2,2
Astronics,0,0,1,0,1
AstroNova Inc,0,0,0,2,2
ATC Group Services,0,0,0,3,3
ATCC,0,0,0,1,1
A-TEK,0,1,1,0,2
Athene,0,0,0,1,1
Atomwise,0,0,1,1,2
Atrium Health,0,1,0,0,1
"Attain, LLC",0,1,0,0,1
"Aucta Pharmaceuticals, Inc.",0,0,0,1,1
Austin Energy,0,0,1,1,2
Authentic8 Inc.,0,0,1,0,1
Autodesk,0,0,0,1,1
Automation Anywhere,0,0,1,0,1
"Availity, LLC.",0,0,0,1,1
Avalara,0,0,0,2,2
Avaya Corporation,0,0,2,0,2
Avery Dennison,0,0,0,1,1
"Avis Budget Group, Inc.",0,1,0,0,1
Axle Informatics,0,1,0,1,2
Axoni,0,0,1,0,1
"Ayco, A Goldman Sachs Company",0,2,0,0,2
BAE Systems,0,2,4,0,6
Baker Hughes,0,0,1,2,3
Bakersfield Heart Hospital,0,1,0,0,1
Ball Aerospace,0,0,3,3,6
Bank of the West,0,2,0,0,2
Banner Health,0,1,0,0,1
Barron Lighting Group I,0,1,0,0,1
"Barton Associates, Inc.",0,1,0,1,2
BASF Corporation,0,0,0,1,1
Battelle,0,0,0,6,6
Baylor Scott & White Health,0,1,0,1,2
"BCS, LLC.",0,1,0,0,1
Beckman Coulter - Life Sciences,0,0,0,1,1
Bed Bath & Beyond,0,1,0,0,1
Bell Flight,0,1,0,0,1
Benefitfocus,0,0,2,0,2
Bennett Aerospace Inc.,0,0,1,1,2
"Bennett Aerospace, Inc.",0,0,0,1,1
Best Buy,0,0,0,1,1
Beth Israel Deaconess Medical Center,0,0,0,1,1
Beyondsoft Consulting,0,0,1,0,1
BGC Partners,0,0,1,0,1
Bible League International,0,0,0,1,1
Bind Benefits,0,3,0,3,6
Biogen,0,0,1,1,2
Biopharma Consulting Services,0,0,0,1,1
Bio-Techne,0,0,0,1,1
BISSELL,0,0,1,0,1
"BJ's Wholesale Club, Inc.",0,1,0,0,1
Blackstone Valley Community Health Care,0,1,0,0,1
Blizzard Entertainment,0,0,2,0,2
"Blue & Co, LLC",0,1,1,1,3
"Blue Cross Blue Shield of IL, MT, NM, OK & TX",0,1,0,2,3
Blue Cross Blue Shield of Louisiana,0,1,0,1,2
Blue Cross Blue Shield of Rhode Island,0,1,0,1,2
Blue Origin,0,0,1,0,1
Blue Shield of California,0,2,0,1,3
BMO Financial Group,0,0,0,1,1
BNP Paribas,0,2,0,0,2
Bodycote,0,0,0,1,1
Boehringer Ingelheim,0,0,0,1,1
BOEING,0,16,32,51,99
BookIt.com,0,0,1,0,1
Bosch Group,0,0,2,7,9
Boston Childrens Health Physicians LLP,0,1,0,0,1
Boston Children's Hospital,0,0,0,1,1
Boston Scientific Corporation,0,0,1,2,3
Bottomline Technologies Inc,0,0,0,1,1
Brandeis University,0,0,0,2,2
BreitBurn Energy,0,0,1,0,1
Bridge Connector,0,1,0,0,1
Bridgevine Inc.,0,1,0,0,1
Brigham & Women's Hospital(BWH),0,1,0,1,2
Bright Health,0,3,2,1,6
BrightBytes,0,0,0,1,1
BrightEdge,0,1,0,0,1
"BrightEdge Technologies, Inc.",0,1,0,0,1
Bristol-Myers Squibb,0,0,0,4,4
Brixmor Property Group,0,1,0,0,1
Broad Institute,0,0,0,1,1
Brookhaven National Laboratory,0,0,1,2,3
Broward County Board of County Commissioners,0,0,0,1,1
Brown & Brown Insurance,0,1,0,0,1
BRS,0,1,0,0,1
Brunswick Corporation,0,1,0,1,2
Bryan Cave,0,4,0,2,6
Burlington Stores,0,2,0,1,3
Burns & McDonnell,0,0,1,3,4
Business Analyst,0,1,0,0,1
Butterfly Network,0,0,3,3,6
BuzzFeed,0,0,0,1,1
Cable One Inc.,0,1,0,2,3
CACI,0,17,4,5,26
Cadence Design Systems,0,0,1,0,1
"Cal Poly, San Luis Obispo",0,1,0,0,1
California Olive Ranch,0,0,0,1,1
CalPortland,0,2,0,0,2
Canandaigua National Bank & Tr,0,1,0,0,1
Cancer Treatment Centers of America,0,1,0,2,3
Cannalysis,0,0,0,2,2
"Canon Business Process Services, Inc.",0,0,1,0,1
Cantel Medical Corporation,0,0,0,1,1
Capital One,0,0,6,7,13
CAPITAL Services,0,0,0,1,1
Carbon Black,0,0,1,0,1
Carbon Lighthouse,0,0,0,1,1
Cardinal Health,0,1,0,0,1
CarePort,0,1,0,0,1
Caring.com,0,0,1,0,1
CarMax,0,1,0,0,1
"Carters, Inc",0,2,0,0,2
Cascade Natural Gas Corporation,0,1,0,0,1
Cascades,0,1,0,0,1
Castlight Health,0,0,1,1,2
Catalyst Lab Solutions,0,0,0,1,1
"Catapult Consultants, LLC",0,4,7,3,14
Catawba County,0,1,0,0,1
Caterpillar,0,1,1,1,3
Catholic Health System,0,0,0,1,1
CDK Global,0,3,1,18,22
CDPHP,0,0,0,1,1
CDW,0,0,0,1,1
Celgene,0,0,0,3,3
"Cell Signaling Technology, Inc",0,0,0,2,2
Centene Corporation,0,1,0,0,1
Centers for Disease Control and Prevention,0,0,0,2,2
Centro,0,0,1,0,1
CGI,0,1,0,5,6
"CGI Group, Inc.",0,3,0,2,5
Chandra Technologies Inc,0,0,0,1,1
Change Healthcare,0,1,1,0,2
Charles Koch Institute,0,0,0,1,1
Charles River Laboratories,0,0,0,3,3
Charles Schwab,0,0,3,0,3
Chemtreat,0,0,0,4,4
Chenega Corporation,0,0,1,0,1
Cherokee Nation Businesses,0,0,0,1,1
Chesapeake Technology Int,0,0,1,1,2
CHI Health,0,0,0,1,1
Child Trends,0,2,0,3,5
Children's Hospital & Medical Center - Omaha,0,0,0,1,1
Children's Hospital Colorado,0,1,0,0,1
Children's Hospital of Philadelphia,0,0,0,1,1
C-HIT,0,4,0,1,5
Cigna,0,1,0,0,1
Cimpress/Vistaprint,0,1,0,0,1
Cincinnati Children's Hospital,0,0,0,1,1
Cirrus Aircraft,0,0,1,0,1
Cirrus Logic,0,0,1,0,1
Cisco Careers,0,4,11,9,24
Citi,0,2,0,3,5
CITIZENS BANK,0,2,0,2,4
City & County of San Francisco,0,7,1,1,9
City National Bank,0,1,0,0,1
City of Austin,0,1,1,0,2
City of Boston,0,1,0,0,1
"City of Boulder, CO",0,1,0,1,2
"City of Cedar Rapids, IA",0,0,0,1,1
City of Columbus,0,1,0,0,1
City of Coon Rapids,0,0,1,0,1
City of Hope,0,1,2,5,8
"City of Houston, TX",0,3,2,2,7
City of Janesville,0,0,0,1,1
"City of Keene, NH",0,0,1,0,1
City of Orlando,0,0,1,0,1
City of Phoenix,0,1,0,0,1
City of Raleigh,0,1,0,0,1
City of Rapid City,0,0,1,0,1
City of Sacramento,0,1,1,0,2
City of San Angelo,0,0,1,0,1
City of San Antonio,0,0,1,1,2
City of San Jose,0,0,1,0,1
"City of SeaTac, WA",0,0,0,1,1
City of Tacoma,0,0,0,1,1
"City of Vallejo, CA",0,1,0,0,1
"Civil & Environmental Consultants, Inc.",0,0,0,3,3
Civis Analytics,0,1,0,4,5
Clark Richardson & Biskup,0,1,0,0,1
Clean Water Services,0,0,0,1,1
ClearlyAgile,0,0,1,1,2
Clemson University,0,0,0,1,1
Cleveland Clinic,0,0,0,1,1
ClickBank,0,0,0,1,1
Cogent Professionals,0,0,0,1,1
Cognizant,0,3,2,3,8
Colas,0,1,0,0,1
Collective Medical,0,1,0,0,1
Collins Aerospace,0,0,7,2,9
Colorado State University,0,0,0,1,1
COLSA,0,2,1,0,3
Comcast,0,2,6,8,16
Comerica Bank,0,1,0,0,1
Commonwealth of Massachusetts,0,1,0,0,1
Commonwealth of PA,0,0,0,1,1
Community College of Rhode Island,0,0,0,1,1
Community Health Services,0,1,0,0,1
Compass Group,0,0,1,0,1
ComplianceBridge,0,0,0,1,1
COMPTROLLER OF PUBLIC ACCOUNTS,0,1,0,1,2
Computacenter Americas,0,0,1,0,1
Computer Staff,0,0,1,0,1
comScore,0,1,0,0,1
Concurrent Technologies Corporation,0,0,0,2,2
Confluent,0,0,1,0,1
Conifer Health Solutions,0,1,0,0,1
ConnectiveRx,0,3,0,5,8
Conservation Legacy,0,0,0,1,1
Constellium,0,0,1,0,1
Consumers Energy,0,0,1,2,3
Contributor Development Partnership,0,1,0,0,1
Control-Tec LLC,0,0,1,0,1
Conversion Logic,0,0,0,1,1
Convoy,0,1,0,2,3
Corning,0,0,0,5,5
CorVel Healthcare Corporation,0,1,0,0,1
CoStar Group,0,0,1,0,1
"County of Marin, CA",0,2,0,0,2
County of Milwaukee,0,3,0,0,3
County of Orange,0,1,0,0,1
County of Riverside,0,1,0,0,1
County of San Mateo,0,0,1,0,1
"County of Ventura, CA",0,0,0,1,1
Coverent,0,0,0,1,1
Covetrus,0,0,0,1,1
Cox Automotive,0,0,4,4,8
Cox Communications,0,1,0,1,2
Crackajack Solutions,0,0,0,1,1
Crain Communications Inc,0,1,0,0,1
Cray,0,0,0,1,1
Credence LLC,0,1,1,1,3
CRGT Inc.,0,1,0,1,2
CRH,0,0,0,1,1
CRISPR Therapeutics,0,0,0,1,1
Cruise Automation,0,1,0,0,1
CSG,0,1,0,0,1
CSL Behring,0,0,1,1,2
CTI And Associates Inc.,0,0,0,5,5
Cuker,0,0,1,1,2
Cummins Inc.,0,0,1,0,1
Current Elliot,0,1,0,0,1
Cushman & Wakefield,0,1,0,0,1
Customs and Border Protection,0,1,0,1,2
Cvent,0,1,1,0,2
CVS Health,0,0,0,2,2
Cybage,0,1,0,1,2
Cytel Inc.,0,0,0,1,1
Daimler,0,3,0,0,3
Dana-Farber Cancer Institute,0,0,0,2,2
Danaher Corporate,0,0,2,4,6
Danone,0,2,0,0,2
Daon Inc,0,0,0,1,1
Data Pioneer,0,0,1,2,3
DataDirect Networks,0,0,0,1,1
"DataSync Technologies, Inc",0,0,0,1,1
Datis,0,1,0,0,1
Daugherty Business Solutions,0,0,1,1,2
DaVita Medical Group,0,2,0,0,2
"Deerland Enzymes, Inc.",0,0,0,2,2
Del Monte Fresh Produce Inc.,0,1,0,0,1
Delaware Valley Floral Group,0,1,0,0,1
Delphinus Engineering,0,1,0,1,2
Delta Air Lines,0,0,0,1,1
Delta Dental of Minnesota,0,1,0,0,1
DELUXE CORPORATION,0,1,0,1,2
Dematic,0,0,0,1,1
Denali Therapeutics,0,0,0,1,1
DentaQuest,0,1,0,0,1
Denton County Electric Cooperative,0,1,0,0,1
Dentsu Aegis Network,0,2,0,1,3
Denver Drug Development Unit,0,0,0,1,1
Department of Veterans Affairs Center for Clinical Management Research,0,0,0,2,2
"Dephy, Inc.",0,0,0,1,1
"d'Escoto, Inc.",0,0,1,0,1
Desert Research Institute,0,0,1,3,4
Designory,0,1,0,0,1
Deutsche Bank,0,1,0,0,1
DexYP,0,0,0,1,1
Digilant,0,0,1,1,2
"Digital Management, LLC",0,0,1,0,1
Digitas,0,2,0,2,4
Discover Financial Services,0,1,1,2,4
DISHER,0,0,1,0,1
Disney Television Animation,0,0,1,0,1
Disneyland Resort,0,0,1,0,1
Dixon Hughes Goodman LLP,0,1,0,1,2
Doble Engineering,0,0,1,0,1
Donnelley Financial Solutions,0,0,1,0,1
Donuts Inc,0,0,1,0,1
Doosan Bobcat,0,0,1,0,1
Dover Fueling Solutions,0,0,1,0,1
Downey Unified School District,0,1,0,0,1
Doyle Security Systems,0,0,0,1,1
DRAX BIOMASS INTERNATIONAL INC,0,0,0,1,1
drchrono,0,1,0,1,2
Drexel University,0,0,1,0,1
DSM Innovation Center,0,0,0,4,4
DSM Nutritional Products,0,1,0,1,2
"DUFF AND PHELPS, LLC",0,1,1,1,3
Duke Energy,0,1,0,1,2
Duke University and Duke University Health System,0,0,0,4,4
Dun & Bradstreet,0,0,1,0,1
DXC,0,1,1,1,3
Eagle Ray Inc,0,1,0,0,1
eBay Inc.,0,0,2,2,4
ecoATM LLC,0,1,0,0,1
Ecolab,0,2,1,2,5
Edelman,0,1,0,0,1
"EDF Trading North America, LLC",0,2,0,1,3
"Edmentum, Inc.",0,0,0,1,1
EDP Renewables North America,0,2,0,0,2
Education Trust,0,0,0,1,1
Edward Jones,0,1,0,0,1
EIS,0,4,0,0,4
elasticiti,0,0,0,1,1
Electronic Arts,0,0,2,0,2
EMD,0,0,1,2,3
Emergent Holdings,0,15,1,6,22
Emerson,0,0,2,1,3
Emory University,0,1,0,0,1
EMSL,0,0,0,1,1
Enable Midstream,0,1,0,0,1
"Encoded Therapeutics, Inc.",0,0,0,1,1
Energy Systems Group,0,0,1,0,1
Energy Transfer Family of Partnerships,0,1,0,0,1
ENGIE North America Inc.,0,1,0,1,2
Enhanced Information Solutions,0,0,0,1,1
Entrust Datacard,0,1,0,0,1
Equifax,0,2,1,2,5
Equinix,0,1,0,0,1
EQUINOX,0,0,3,0,3
Equipment,0,1,0,0,1
"Ervin Cable Construction, LLC",0,1,0,0,1
Essentia Health,0,1,0,0,1
Esterline Technologies Corporation,0,0,1,0,1
"Eurofins EAG Materials Science, LLC",0,0,0,1,1
"Eurofins Lancaster Laboratories Professional Scientific Services, LLC",0,0,0,2,2
"Eurofins Viracor, Inc.",0,0,0,1,1
Eventbrite,0,1,2,1,4
Ever-Green Energy Inc,0,1,0,1,2
EVERSOURCE,0,1,0,0,1
Exact Sciences,0,0,0,1,1
Exact Sciences Corporation,0,0,0,2,2
Exegy,0,0,2,1,3
Exelon,0,2,0,3,5
Expedia,0,0,1,1,2
Expeditors,0,1,0,0,1
Expeditors NL,0,1,0,0,1
Exponent,0,0,0,1,1
Express Scripts,0,1,0,2,3
EY,0,1,1,1,3
F.N.B. Corp.,0,1,0,0,1
"Faction, Inc.",0,0,0,1,1
Fairfax County Government,0,1,0,0,1
Family Services Inc,0,0,0,1,1
Fannie Mae,0,1,1,0,2
"FCS International, Inc. (dba FirstCarbon Solutions, ADEC Innovations, ADEC Solutions-USA)",0,1,0,0,1
Federal Aviation Administration,0,1,2,0,3
Federal Reserve Bank of Chicago,0,0,1,1,2
FedEx Office,0,1,0,1,2
FedEx Services,0,1,1,1,3
Fidelity Investments,0,3,0,0,3
Fifth Third Bank,0,1,3,1,5
First Horizon,0,1,0,0,1
First Quality,0,0,0,2,2
"FirstLight Home Care Franchising, LLC",0,1,0,0,1
FIS Global,0,2,0,0,2
Fitch Ratings,0,1,0,1,2
Flagler College,0,1,0,0,1
FlightSafety International,0,0,1,0,1
FLIR Systems,0,0,1,0,1
Floor & Decor,0,1,0,0,1
Florida Blue,0,1,0,1,2
Florida State University,0,1,0,2,3
Forcepoint,0,0,1,0,1
Foreground Security,0,1,1,1,3
Fossil Group,0,1,0,0,1
"Foundation Medicine, Inc.",0,0,0,1,1
Fox Corporation,0,1,1,1,3
"FOX FACTORY, INC.",0,0,1,0,1
Fred Hutchinson Cancer Research Center,0,0,0,4,4
Freddie Mac,0,0,0,3,3
FREEDOM CONSULTING GROUP,0,0,0,1,1
Freedom Photonics,0,0,0,1,1
Fresenius Kabi,0,0,1,1,2
Freya Systems,0,0,0,1,1
Froedtert,0,1,0,1,2
Frontwave Credit Union,0,1,0,0,1
FuelX,0,0,1,1,2
Fulcrum Co.,0,1,0,0,1
Fulcrum Therapeutics,0,0,0,4,4
G&J Pepsi-Cola Bottlers,0,2,0,0,2
G4S,0,1,0,0,1
GAF Materials Corporation,0,1,0,0,1
Garmin,0,0,2,2,4
Gates Corporation,0,0,0,2,2
Geisinger,0,2,0,4,6
Genentech,0,0,2,4,6
General Atomics and Affiliated Companies,0,3,1,2,6
General Communication Inc.,0,2,0,0,2
General Dynamics Information Technology,0,1,2,4,7
General Electric,0,2,9,6,17
General Mills,0,1,0,0,1
General Motors,0,0,1,1,2
GenMark Diagnostics,0,0,1,0,1
Genomic Health,0,0,1,1,2
Georgia Tech Research Institute,0,0,0,1,1
Geosyntec Consultants,0,0,1,1,2
GfK,0,0,0,1,1
Globus Medical,0,0,0,1,1
"GLOVIS America, Inc.",0,1,0,0,1
Glu Mobile,0,4,3,8,15
GM Financial,0,1,0,0,1
GoDaddy,0,0,1,0,1
GoHealth Urgent Care,0,1,0,0,1
Goldbelt Falcon,0,2,0,0,2
"Goldbelt, Inc.",0,2,0,0,2
Good Foods Group,0,1,0,0,1
GOTTLIEB,0,1,0,0,1
Grainger,0,2,0,2,4
Grant Thornton,0,1,0,0,1
Gravity Technologies inc,0,0,0,1,1
Greater Baltimore Medical Center,0,0,0,1,1
Greeley and Hansen,0,0,2,0,2
"Greystone & Co., Inc.",0,1,1,0,2
Grifols,0,0,0,1,1
Grove Collaborative,0,0,1,1,2
"Growers Edge Financial, Inc.",0,0,0,1,1
GSI Service Group Inc,0,0,0,1,1
Guidehouse,0,1,0,0,1
"Guidewire Software, Inc.",0,1,0,0,1
Gurutech Solutions,0,0,0,1,1
H3 Biomedicine,0,0,0,1,1
Haley & Aldrich,0,0,1,2,3
Hallmark,0,1,0,1,2
Hanmi Bank,0,1,0,0,1
Happy Money,0,0,0,1,1
Hawaii Medical Service Association,0,1,0,0,1
Hawaii State Federal Credit Union,0,1,0,0,1
Hawaiian Airlines,0,1,0,0,1
Haworth,0,1,0,0,1
HCA Corporate,0,1,1,1,3
HCA Healthcare,0,1,0,0,1
HCI | integrated solutions,0,3,0,0,3
HDR,0,1,0,5,6
HDR Inc.,0,0,0,1,1
Health & Human Services Comm,0,2,0,1,3
Health Support Center,0,0,0,1,1
Healthline Media,0,1,0,1,2
Healthtrust Supply Chain/Purchasing Group,0,3,2,0,5
Henry Ford Health System,0,2,2,3,7
HERE Technologies,0,0,0,1,1
Hexagon Geosystems,0,1,0,0,1
Hexcel Corporation,0,0,0,1,1
High Point University,0,1,0,0,1
Highmark Health,0,0,0,2,2
Hill Holliday,0,1,0,2,3
Hillsborough County Public Schools,0,0,1,0,1
Hillsborough County Sheriffs Office,0,1,0,1,2
"Hillsborough County, FL",0,0,1,0,1
"Hillsborough County, Florida",0,0,1,0,1
Hiscox Ltd,0,2,0,0,2
HM Health Solutions,0,1,1,0,2
HMS,0,2,2,3,7
HomeAway,0,1,0,1,2
Homesite Insurance,0,1,0,1,2
"Honda R&D Americas, Inc.",0,0,2,0,2
Honeywell,0,5,5,0,10
Horizon Blue Cross Blue Shield of New Jersey,0,1,0,1,2
Housecall Pro,0,2,2,2,6
Howard Hughes Medical Institute,0,0,0,2,2
HR Green,0,0,1,0,1
HSHS St. John's Hospital,0,0,0,1,1
Huawei,0,0,0,1,1
Huhtamaki Group,0,1,0,0,1
Human Coalition,0,0,0,1,1
Humana,0,0,0,1,1
HumCap Recruiting,0,0,1,0,1
Huntington Ingalls Industries,0,1,1,1,3
HX5,0,1,1,0,2
Hyalex,0,0,0,1,1
I3 Infotek,0,0,3,0,3
IBM,0,0,0,1,1
ICF,0,1,0,2,3
IDEA Public Schools,0,3,0,0,3
Iflex Global Solutions,0,1,0,1,2
"IHRC, Inc.",0,0,0,2,2
II-VI / M Cubed Technologies,0,0,0,1,1
"Illinois CancerCare, P.C.",0,0,0,1,1
Imaging Endpoints,0,0,1,0,1
Incyte Corporation,0,0,0,1,1
In-Depth Genomics,0,0,0,1,1
Indiana University,0,0,0,1,1
Indigo,0,0,0,1,1
Indyme Solutions LLC,0,0,0,1,1
Inflow-ns,0,0,0,1,1
InfoArmor Inc,0,0,1,0,1
Infoblox,0,0,3,0,3
Informa,0,1,0,0,1
Informatica,0,0,1,0,1
INGELLICOM,0,0,0,1,1
Ingersoll Rand,0,1,0,0,1
Ingredion,0,0,0,1,1
Inovalon,0,0,0,1,1
"Inscopix, Inc.",0,0,0,1,1
Insight,0,1,1,0,2
"Insight Enterprises, Inc.",0,1,1,0,2
Insignia Technology Services LLC,0,1,0,0,1
insitro,0,0,0,1,1
"Institute for Medical Research, Inc",0,0,0,1,1
Instructure,0,1,0,0,1
"Integrated DNA Technologies, Inc",0,0,0,1,1
Integrity Applications Incorporated,0,2,1,2,5
IntelliWare Systems,0,1,0,0,1
Intelsat,0,1,0,0,1
Inter Vision,0,0,1,0,1
Interior Logic Group,0,1,0,0,1
Intermountain Healthcare,0,4,1,1,6
Interos,0,1,0,1,2
Intertek,0,0,0,1,1
Intradiem Inc,0,0,1,0,1
Intralinks,0,0,1,1,2
Intralot,0,0,1,0,1
Intuit,0,1,2,0,3
Intuitive Surgical,0,0,1,0,1
InVision Studio,0,0,1,0,1
Invitae,0,0,0,1,1
IQVIA,0,1,0,5,6
iRobot Corporation,0,0,1,0,1
IsoPlexis,0,0,0,3,3
IT Giant,0,0,0,1,1
J. Craig Venter Institute,0,0,0,1,1
"J.Crew Group, Inc.",0,1,0,0,1
Jacobs,0,0,2,3,5
JDA Software,0,0,1,0,1
"Jefferson - Center City, Philadelphia, PA",0,1,0,0,1
"Jefferson County, CO",0,0,1,0,1
Jetblack,0,1,0,0,1
JLL,0,1,1,0,2
John I. Haas,0,0,0,2,2
Johns Hopkins University,0,0,0,1,1
Johns Manville,0,0,0,1,1
Johnson & Johnson Family of Companies,0,0,0,32,32
Joie,0,1,0,0,1
Juniper Systems,0,0,1,2,3
JUSTDATE,0,0,0,1,1
JUUL Labs,0,1,1,2,4
K2,0,0,1,0,1
"K2 Group, Inc.",0,1,0,0,1
Kaiser Permanente,0,2,1,4,7
Kaman Distribution,0,1,0,0,1
Karma Automotive,0,1,0,0,1
Karmanos Cancer Institute,0,0,0,1,1
Katalyst Healthcares & Life Sciences,0,0,1,2,3
Katmai Government Services,0,0,0,1,1
KBR,0,1,2,2,5
KBRWyle,0,1,2,2,5
"Kelmar Associates, LLC",0,0,0,1,1
KEMET Electronics Corporation,0,1,0,1,2
"Kennametal, Inc.",0,0,1,2,3
Ketchum,0,2,0,0,2
Keyseries,0,3,1,2,6
Keystone Human Services,0,1,0,0,1
KEYW Corporation,0,0,1,0,1
Keywords Studios,0,0,0,1,1
Kichler,0,0,1,0,1
Kiewit Corporation,0,1,1,0,2
Kimberly-Clark,0,1,1,0,2
Kinect,0,0,0,1,1
King County,0,1,0,1,2
Klarna,0,0,0,1,1
KLA-Tencor,0,0,3,3,6
Kleinfelder,0,0,0,1,1
"Kleinfelder, Inc.",0,0,0,1,1
KOCH BUSINESS SOLUTIONS,0,1,0,0,1
KOCH SUPPLY AND TRADING,0,0,0,1,1
KOHLS,0,0,0,2,2
"Koniag, Inc.",0,1,0,0,1
KORNFERRY,0,0,0,1,1
KRG TECH,0,0,0,1,1
KSM Consulting,0,1,3,4,8
KUBRA,0,1,0,1,2
L3 Technologies,0,1,2,1,4
LabCorp,0,0,0,1,1
Landis+Gyr,0,1,1,0,2
"Landstar System Holdings, Inc.",0,1,0,0,1
Laureate Education,0,1,0,0,1
Lawrence Berkeley National Laboratory,0,0,0,3,3
Legal & General America,0,0,0,1,1
Legion Systems,0,0,0,1,1
Leidos,0,7,8,24,39
Lenovo,0,1,1,1,3
LEO Pharma,0,0,0,1,1
"LERETA, LLC",0,0,3,3,6
LG Chem Michigan Inc.- Tech Center,0,0,1,0,1
LG Electronics,0,0,1,0,1
Libbey,0,1,0,1,2
Liberty Mutual Insurance,0,0,0,1,1
Lieberman Research Worldwide,0,0,0,1,1
Life University Inc,0,0,0,1,1
"LifeLink Foundation, Inc.",0,0,0,2,2
Lifespan,0,0,0,1,1
Lincoln Industries,0,0,1,0,1
LiniumTalentAcquistion,0,1,0,1,2
Lionbridge Technologies,0,0,1,3,4
Livent,0,0,1,0,1
Loc Performance,0,1,1,0,2
Loch Harbour Group Inc,0,1,0,0,1
LOCKHEED MARTIN CORPORATION,0,2,6,4,12
Lodi Memorial Hospital Association,0,0,0,1,1
Los Angeles County Department of Human Resources,0,1,0,0,1
"Lourdes, NY",0,0,0,1,1
Lovelace Respiratory Research Institute,0,0,1,1,2
Lovepop,0,0,1,1,2
Lowe's Inc.,0,1,0,0,1
LSUHSC,0,2,0,0,2
Lubrizol Corporation,0,0,1,0,1
Lumiata,0,0,0,2,2
Luminex,0,0,0,1,1
Lutz,0,0,1,0,1
M&T Bank,0,1,0,0,1
M/A Com Technolgy Solutions,0,0,1,0,1
Mac Papers Inc,0,1,0,0,1
Magellan Health,0,1,0,0,1
"Magic Leap, Inc.",0,1,1,0,2
ManTech International Corporation,0,2,0,0,2
Manulife,0,1,2,0,3
MapR,0,0,0,1,1
"Maricopa County, AZ",0,1,0,1,2
"Marriott International, Inc",0,1,1,0,2
Maryville University,0,0,0,1,1
Massachusetts General Hospital(MGH),0,0,0,1,1
MassBiologics - University of Massachusetts Medical School,0,0,0,2,2
MassMutual,0,1,0,1,2
Mast Global,0,1,1,0,2
Mathematica Policy Research,0,0,0,1,1
Mayo Clinic,0,0,0,2,2
McGraw-Hill,0,0,3,0,3
MCKEAN DEFENSE/CABRILLO TECHNOLOGIES,0,1,0,0,1
McKesson,0,1,0,1,2
McLaren Health Care Corp,0,1,0,0,1
MD Anderson Cancer Center,0,0,0,3,3
MDC Vacuum,0,0,1,0,1
Mead Johnson Nutrition,0,0,0,1,1
Measurement Analysis Corporation,0,0,1,0,1
Medical College of Wisconsin,0,0,0,1,1
Medical University of South Carolina,0,1,0,0,1
Medidata Solutions,0,1,0,0,1
Mednax,0,1,0,0,1
Medtronic,0,0,2,2,4
Meggitt,0,0,1,0,1
"MELE Associates, Inc",0,1,0,0,1
MEMIC,0,0,0,1,1
Memorial Hermann,0,0,0,1,1
Memorial Sloan Kettering,0,0,0,2,2
Merck USA,0,0,0,7,7
Mercury Systems,0,0,2,0,2
Mercy Health,0,1,0,2,3
Mercy Health System of Chicago,0,0,0,1,1
Mercy Hospital in Iowa City,0,1,0,0,1
Meridian Health Plan,0,1,0,0,1
Meridian Technology Group,0,1,0,0,1
Merieux NutriSciences,0,0,0,1,1
Merkle Inc.,0,1,0,1,2
Merz North America,0,0,0,1,1
Meso Scale Diagnostics,0,0,0,3,3
MetLife,0,1,1,4,6
Metra Railroad,0,0,0,1,1
Metropolitan Washington Airports Authority,0,1,5,0,6
MetroStar Systems,0,0,0,1,1
Mettler Toledo,0,0,0,1,1
MFS Investment Management,0,1,0,1,2
MI Bioresearch,0,0,0,1,1
Micro Center,0,0,1,0,1
Micro Focus,0,0,2,2,4
"Microbac Laboratories, Inc.",0,1,0,2,3
Micron,0,0,1,2,3
Midland States Bancorp,0,1,6,1,8
Midland States Bank,0,2,6,2,10
"MINDBODY, Inc",0,3,0,0,3
Mirakl,0,0,1,0,1
Mississippi State Personnel Board,0,0,0,1,1
MIT Lincoln Laboratory,0,1,1,1,3
Mitel,0,0,1,0,1
Mitigation Management,0,0,0,1,1
Mitre Corporation,0,2,2,5,9
MMGY Global LLC,0,0,0,2,2
Mobiquity,0,1,0,1,2
Moda Health,0,2,0,2,4
"Moderna Therapeutics, Inc",0,0,0,3,3
Moffitt Cancer Center,0,0,0,5,5
Mohawk Industries,0,1,0,0,1
Molex,0,0,1,0,1
Molina Healthcare,0,1,0,0,1
Monster Energy,0,1,0,1,2
"MORI Associates, Inc.",0,0,0,1,1
Morneau Shepell,0,1,0,1,2
Motorola Solutions,0,1,1,2,4
Mount Sinai,0,1,0,5,6
Mr. Cooper,0,0,2,1,3
MSA Safety Inc.,0,1,0,0,1
MSCI Inc.,0,0,1,1,2
Mylan,0,0,1,0,1
N C Q A,0,1,0,0,1
National Aerospace Solutions,0,0,0,1,1
National Computer Systems,0,0,0,2,2
National Debt Relief,0,2,0,0,2
National Football League,0,0,1,0,1
National General Insurance,0,2,0,1,3
NATIONAL GRID CO USA (NE POWER),0,1,0,0,1
National Renewable Energy Laboratory,0,0,1,4,5
National Steel and Shipbuilding Com,0,0,1,2,3
Nationwide Children's Hospital,0,0,0,2,2
Navy Exchange Service Command,0,1,0,0,1
NBCUniversal,0,2,1,1,4
NC A&T State University,0,1,0,0,1
NC State University,0,1,0,4,5
NCR,0,2,0,0,2
NCSA - Next College Student Athlete,0,0,0,1,1
Nelson Mullins Riley & Scarborough LLP,0,1,0,0,1
neo4j.com,0,0,1,1,2
Neos Consulting,0,1,0,2,3
Nestle Purina PetCare Company,0,1,0,0,1
NetApp,0,1,4,0,5
Network Analyst,0,1,0,0,1
Network Services Co.,0,1,0,0,1
Neuberger Berman,0,1,0,1,2
"Neustar, Inc.",0,1,1,2,4
New York City DEPARTMENT OF INVESTIGATION,0,0,0,1,1
New York City DEPT OF PARKS & RECREATION,0,0,0,1,1
New York City POLICE DEPARTMENT,0,1,0,4,5
New York Genome Center,0,0,0,1,1
New York State Office of the Attorney General (OAG),0,0,0,2,2
New York University,0,1,0,0,1
Newport Group,0,0,1,1,2
Nexleaf Analytics,0,0,0,2,2
NexTek,0,1,0,0,1
NextEra Energy,0,1,0,0,1
NICE inContact,0,0,1,0,1
NICO Info Systems,0,1,0,0,1
NIKE INC,0,1,2,2,5
Nilfisk,0,3,0,1,4
"Noble Energy, Inc.",0,1,0,3,4
Noblis,0,1,0,1,2
Nokomis Inc.,0,0,0,3,3
Nordstrom,0,1,0,1,2
Norfolk Southern Corp,0,0,1,0,1
North American Lighting,0,0,1,0,1
North Carolina A&T,0,1,0,0,1
North Carolina State University,0,2,0,2,4
Northeastern University,0,0,0,1,1
Northern Trust Corp.,0,2,0,0,2
Northrop Grumman,0,3,8,4,15
NorthTide Group,0,0,1,0,1
Norwegian Cruise Line Holdings Ltd.,0,1,0,0,1
Norwich University,0,0,0,1,1
"Novolex Holdings, Inc.",0,1,0,0,1
nscglobal,0,0,1,0,1
NVIDIA,0,0,0,1,1
"NxStage Medical, Inc.",0,1,0,0,1
NYC Administration for Children's Services,0,1,0,1,2
NYU Langone,0,0,0,10,10
NYU Langone Health,0,0,0,1,1
Oak Ridge National Laboratory,0,0,0,1,1
Oath Inc,0,0,2,0,2
"Odyssey Systems Consulting Group, Ltd",0,0,1,0,1
OGSystems,0,0,0,1,1
Ohio University,0,0,0,1,1
Okta,0,0,1,0,1
OMD,0,2,0,0,2
omega solutions inc,0,0,0,1,1
Omnicell,0,0,1,1,2
One Gas,0,1,0,0,1
OneBlood,0,0,0,1,1
OneDigital,0,1,0,0,1
OneNeck IT Solutions,0,0,1,0,1
OODA Health,0,0,0,1,1
Options Clearing Corporation,0,1,0,0,1
"OptiWorks, Inc.",0,0,1,0,1
Optoro,0,0,1,0,1
Opus 12,0,0,0,1,1
Oracle,0,0,0,2,2
OrangePeople,0,1,1,0,2
ORBIS Corporation,0,1,0,0,1
Oregon State University,0,0,0,1,1
Ortho Clinical Diagnostics,0,0,0,2,2
Osage Nation Environmental Solutions,0,0,0,1,1
Osaro,0,0,1,2,3
Overstock.com Inc.,0,0,1,2,3
"Pace Analytical Services, LLC",0,0,0,2,2
Pacific Biosciences,0,0,0,2,2
Pacific Gas And Electric Company,0,1,1,3,5
Pacific Office Automation,0,0,1,0,1
PAH Management,0,0,1,0,1
Palmetto Health,0,1,0,1,2
Palo Alto Networks,0,0,2,0,2
Panasonic Avionics,0,1,1,1,3
Panasonic Energy of North America,0,0,2,0,2
Paragon Bioservices Inc.,0,0,1,2,3
Parametric Solutions Inc.,0,0,1,0,1
Park Dental,0,1,0,1,2
Parker Hannifin Corporation,0,0,5,0,5
"Parks, Experiences and Products",0,0,0,1,1
Parsons,0,1,5,3,9
Partners HealthCare(PHS),0,1,0,0,1
"Pasco County, FL",0,2,3,1,6
Passport,0,1,0,1,2
Paxio Inc,0,0,1,0,1
Paychex Inc.,0,0,1,0,1
Paypal,0,0,1,3,4
"PDX, Inc.",0,1,0,0,1
Pearl,0,1,0,0,1
Pearl Insurance Group LLC,0,1,0,0,1
Pearson,0,0,0,2,2
"PennyMac Loan Services, LLC",0,0,0,2,2
"Performance Health Sciences, Inc.",0,0,0,1,1
Performics,0,1,0,0,1
Perspecta,0,1,2,4,7
Pet Supplies Plus,0,1,0,1,2
"Pharmacyclics, an Abbvie Company",0,0,0,2,2
Philips,0,0,1,0,1
Phillips-Medisize,0,0,1,0,1
Phinizy Center for Water Sciences,0,0,0,1,1
Piedmont Healthcare,0,1,0,0,1
Pine Point Group,0,0,0,1,1
PINKERTON,0,0,0,1,1
Piper Companies,0,1,1,2,4
Pivotal Search Partners,0,0,0,1,1
pladis,0,0,1,0,1
Planned Parenthood Northern California,0,0,0,1,1
Plug Power Inc,0,0,1,0,1
Plus Relocation Services,0,1,0,0,1
Point B,0,1,0,0,1
Pond & Company,0,1,0,0,1
Postlethwaite & Netterville,0,1,0,3,4
PPC Partners Inc.,0,0,1,0,1
PPD,0,1,0,2,3
PRA Health Sciences,0,0,0,1,1
Pratt & Whitney,0,0,1,0,1
Praxis Engineering,0,1,1,0,2
Prelude Therapeutics Incorporated,0,0,0,2,2
Premier Health,0,1,0,0,1
Presbyterian Healthcare Services,0,0,0,5,5
Priceline.com,0,0,1,1,2
Primus Builders Inc.,0,0,1,0,1
"Prince George's County, MD",0,0,0,1,1
Privia Health,0,0,0,1,1
Procter and Gamble,0,0,0,1,1
Proofpoint,0,0,3,1,4
Prosync Technology Group,0,0,1,0,1
Proton Dealership IT,0,0,1,0,1
Prudential,0,0,0,2,2
PSCU,0,1,0,0,1
PSEG,0,0,2,0,2
Publicis Media,0,1,1,2,4
Publicis.Sapient,0,0,9,8,17
PwC,0,2,0,8,10
Qlarion,0,0,0,4,4
Qualcomm,0,1,0,1,2
Quest Analytics,0,0,1,0,1
Quest IT Solutions,0,1,1,1,3
Quicken Loans,0,2,0,0,2
Quiksilver,0,1,0,1,2
R1 RCM Inc.,0,1,0,0,1
Raas Infotek,0,0,0,1,1
Radiant Solutions,0,2,2,3,7
Ralph Lauren,0,1,0,0,1
Ramboll Group,0,0,0,2,2
RAND Corporation,0,0,1,0,1
Randa Accessories,0,1,0,1,2
Raritan Valley Community College,0,0,0,2,2
RAYMOND JAMES FINANCIAL,0,1,0,0,1
Raytheon,0,2,3,3,8
RB,0,0,0,1,1
RB Health,0,0,0,1,1
RBC,0,1,0,0,1
RealPage,0,1,0,0,1
RealTruck,0,0,1,0,1
"Red Hat, Inc.",0,0,1,1,2
"Red Robin International, Inc.",0,4,3,3,10
Redox Power Systems,0,0,1,0,1
Refinitiv,0,1,1,1,3
Regeneron,0,0,0,2,2
Regions Bank,0,1,0,0,1
REI,0,0,1,1,2
Repligen Corp,0,0,0,1,1
Republic Parking System,0,0,0,1,1
Retail Business Services,0,5,0,0,5
REV Group,0,0,0,1,1
Revionics,0,0,0,2,2
Reynolds and Reynolds,0,1,1,1,3
RGA,0,0,0,1,1
Ricoh,0,1,0,0,1
Rigetti Computing,0,0,0,1,1
Riley Power,0,0,1,0,1
RiskSpan,0,1,0,1,2
Robertet Inc,0,0,0,2,2
Robotic Research Llc,0,0,4,0,4
Roche,0,1,0,0,1
Rockland Trust,0,1,0,0,1
Rogers & Cowan,0,1,0,0,1
Rolls-Royce,0,0,1,0,1
RP Pro Services,0,0,0,1,1
"RSUI Group, Inc.",0,1,0,0,1
RTI International,0,2,0,0,2
Russell Investments,0,1,0,0,1
Rutgers University,0,0,0,1,1
RWJBarnabas Health,0,0,0,1,1
Ryan Specialty Group,0,1,0,0,1
"Ryan Specialty Group, LLC",0,1,0,0,1
S&P Global,0,0,2,2,4
S&P GLOBAL MARKET INTELLIGENCE,0,0,1,0,1
Saalex Solutions Inc,0,0,1,0,1
Safran,0,0,1,0,1
Saft America,0,0,0,1,1
Saft Batteries,0,0,0,1,1
SAIC,0,2,5,3,10
SailPoint,0,0,1,0,1
SailPoint Technologies Holdings,0,0,1,0,1
Saint Francis Health System,0,0,0,1,1
"Saint Thomas Health, TN",0,0,0,1,1
Salesforce,0,0,1,2,3
Salient CRGT,0,1,0,1,2
"Salient Federal Solutions, Inc.",0,0,0,1,1
Salt Lake Community College,0,0,0,1,1
Sam's Club,0,0,0,1,1
Samsung Electronics,0,0,2,0,2
Samsung NEXT,0,0,1,0,1
Samsung SDS America,0,0,1,0,1
San Francisco Health Plan,0,1,0,0,1
San Jose/Evergreen Community College District,0,0,0,1,1
Sandia National Laboratories,0,0,1,2,3
Sanford Burnham Prebys Medical Discovery Institute,0,1,0,2,3
Sanford Health,0,0,0,2,2
Sangamo Therapeutics,0,0,0,1,1
Sanmina Corporation,0,0,0,1,1
Sanofi,0,1,0,1,2
Santa Monica Seafood,0,1,0,1,2
Santa Monica Seafood Company,0,1,0,1,2
SAP,0,0,0,1,1
Sargent & Lundy,0,0,1,0,1
Sartorius Corporation,0,0,0,2,2
SBA Communications,0,0,1,0,1
"SBA Network Services, LLC",0,0,1,0,1
SBG Technology Solutions,0,0,1,1,2
Scholastic,0,0,0,1,1
Scientific Games,0,1,0,0,1
SCOR,0,1,0,0,1
"Scott County, MN",0,1,0,1,2
SCOTT SPORTS,0,1,0,0,1
SDLC Partners,0,1,0,1,2
SDSU Research Foundation,0,1,0,1,2
Seagate Technology,0,1,0,1,2
Sealed Air Corporation,0,0,0,3,3
Sears Holdings Management Corporation,0,1,0,0,1
Seashine Financial,0,1,0,0,1
Sedgwick,0,0,0,2,2
SEH Inc.,0,0,1,1,2
SEI,0,4,0,1,5
Selfhelp,0,0,0,1,1
Semantic-AI,0,0,0,1,1
SEMI,0,0,0,2,2
Sentry Insurance,0,1,1,0,2
Sephora,0,0,0,2,2
SERCO INC.,0,1,0,0,1
ServiceNow,0,0,1,2,3
Servsys,0,0,1,0,1
SGS,0,0,1,1,2
Shamrock Foods,0,2,2,0,4
Sharp Healthcare,0,1,0,1,2
Shelby County Government,0,1,0,1,2
Shell,0,0,2,0,2
Shimano,0,1,0,0,1
Shirley Ryan Ability Lab,0,0,0,2,2
Sidecar,0,0,0,1,1
Sierra Lobo,0,0,1,0,1
Sierra Nevada Corporation,0,0,2,0,2
Signal Laboratories,0,0,1,0,1
SimilarWeb,0,1,0,0,1
Simon Property Group,0,0,1,0,1
Sirius Computer Solutions,0,0,0,1,1
"Skadden, Arps, Slate, Meagher & Flom LLP & Affiliates",0,1,0,1,2
Slack,0,0,1,0,1
Smiths Medical,0,1,0,0,1
Snowflake Computing,0,0,1,1,2
Société Générale,0,1,0,0,1
"Socially Determined, Inc.",0,0,0,1,1
Society of Petroleum Engineers,0,0,0,1,1
Sodexo Inc.,0,0,1,0,1
SoFi,0,2,0,0,2
Softheon,0,0,0,3,3
Softvision,0,0,0,1,1
SoftVision - North America & UK,0,0,0,2,2
Software Engineering Institute,0,0,1,2,3
Solugenix Corporation,0,1,0,0,1
"Somalogic, Inc.",0,0,1,2,3
Sonic Healthcare USA,0,0,0,1,1
Sonora Quest Laboratories,0,0,0,1,1
Sony Pictures Entertainment Inc.,0,2,0,0,2
South Shore Health,0,1,0,0,1
Southern California Edison,0,0,1,0,1
Southern Company,0,2,0,2,4
Southwest Airlines,0,1,0,3,4
Southwest Research Institute,0,0,1,1,2
"Spark Energy, L.P.",0,1,0,0,1
Spark Therapeutics,0,0,0,3,3
Spear Education,0,1,0,0,1
"Special Olympics, Inc.",0,0,1,0,1
Spectra Logic,0,0,1,0,1
Spectrum,0,2,0,0,2
Speedway LLC,0,1,0,0,1
SPH Analytics,0,1,0,0,1
SphereOI Studios,0,0,0,1,1
Sportradar,0,0,1,0,1
Sportradar AG,0,0,1,0,1
Sports Science Lab,0,0,0,1,1
Sprint,0,2,0,0,2
SSI,0,0,0,1,1
St. John Knits,0,1,0,0,1
St. Joseph Healthcare,0,0,1,0,1
"St. Mary's Healthcare, NY",0,1,0,0,1
"St. Vincent's Health System, AL",0,0,0,3,3
"St. Vincent's HealthCare, FL",0,0,0,1,1
"Stage 4 Solutions, inc.",0,1,0,0,1
Staples,0,2,0,0,2
Starcom,0,0,0,1,1
State Farm,0,1,2,0,3
State of Arizona,0,0,1,1,2
State of Colorado Job Opportunities,0,3,2,1,6
State of Connecticut - Department of Transportation,0,0,2,0,2
State of Delaware,0,0,0,1,1
State of Georgia,0,1,0,0,1
State of Indiana,0,3,2,0,5
State of Louisiana,0,1,0,0,1
State of Minnesota,0,1,0,0,1
State of Mississippi,0,0,0,1,1
State of Montana,0,1,0,2,3
State of New Mexico,0,0,1,0,1
State of North Carolina,0,1,0,3,4
State of Ohio Jobs,0,0,1,3,4
State of South Carolina,0,1,0,3,4
State of Washington Dept. of Labor & Industries,0,0,1,0,1
State of Washington Health Care Authority,0,1,0,0,1
State of Washington State Investment Board,0,0,1,0,1
State of Wisconsin,0,1,0,0,1
State Street,0,0,0,1,1
Ste. Michelle Wine Estates,0,0,0,1,1
Steward Health Care,0,3,2,5,10
Steyer,0,0,0,1,1
Stifel,0,3,0,5,8
Stony Brook University,0,0,1,2,3
Stryker,0,0,1,0,1
STV,0,0,0,1,1
SUEZ,0,0,1,1,2
Suez in North America,0,1,0,1,2
"Sullair, LLC",0,0,0,1,1
SullivanCotter,0,1,0,0,1
SumTotal,0,0,1,0,1
SumTotal Systems,0,0,1,0,1
Sunpower,0,0,1,1,2
SunSoft Technologies,0,1,0,0,1
SunTrust,0,3,0,1,4
Sunwest Bank,0,1,0,0,1
Supercell,0,0,0,1,1
Sustainserv,0,0,0,1,1
Sutter Health,0,2,0,1,3
Swisslog,0,0,1,0,1
Syneos Health Clinical,0,0,0,1,1
Syneos Health Commercial Solutions,0,0,0,1,1
Synovus,0,1,0,0,1
System1,0,0,0,1,1
Tableau,0,1,2,2,5
Taboola,0,1,2,2,5
Takeda Pharmaceutical,0,1,0,3,4
Talis Biomedical Corp,0,0,0,2,2
"Tampa Armature Works, Inc",0,0,1,0,1
Tapestry Solutions,0,0,1,1,2
TARGET,0,0,1,0,1
TDS Telecom,0,0,1,0,1
Teachers College Columbia University,0,1,0,0,1
Teachers Credit Union,0,1,0,0,1
"Team Industrial Services, Inc.",0,0,1,0,1
Team Red Dog,0,1,0,0,1
Technimark - Asheboro,0,0,0,1,1
Technology Credit Union,0,1,0,0,1
Teco Energy,0,1,0,1,2
TEGNA,0,1,0,0,1
TekSynap,0,0,2,0,2
Tektronix,0,0,1,0,1
Telenav,0,0,1,0,1
Telia Company,0,1,0,0,1
Ten-X,0,1,0,1,2
Terumo Medical Corporation,0,0,1,0,1
Tetra Tech,0,0,0,3,3
Texas A&M University,0,0,0,1,1
Texas Children's Hospital,0,1,0,0,1
Texas Department of Transportation,0,0,2,0,2
TEXAS MILITARY DEPARTMENT,0,0,1,0,1
Texas Tech Unv Hlth Sci Ctr El Paso,0,0,0,1,1
Textio,0,0,2,6,8
The Aerospace Corporation,0,2,4,8,14
The Allen Institute for Artificial Intelligence,0,0,1,1,2
The Arcanum Group,0,1,0,0,1
The Boston Consulting Group,0,0,1,2,3
The Broad Center,0,1,0,1,2
The Climate Corporation,0,0,1,2,3
The Coca-Cola Company,0,2,2,3,7
The Davey Tree Expert Company,0,0,0,2,2
The Emmes Corporation,0,0,0,1,1
The Field Museum,0,0,0,1,1
The Henry M. Jackson Foundation,0,0,0,1,1
The Hershey Company,0,0,1,3,4
The Home Depot,0,1,0,0,1
The J. M. Smucker Company,0,1,0,0,1
The J. Paul Getty Trust,0,0,0,2,2
The Jackson Laboratory,0,0,0,6,6
The Jewish Board,0,1,0,1,2
The Marine Mammal Center,0,0,0,1,1
The National Academies,0,0,0,1,1
the NBA,0,1,0,0,1
The NPD Group,0,1,0,0,1
The Ohio State University,0,0,0,8,8
The Research Foundation for The State University of New York at Stony Brook,0,0,0,1,1
The Sperm Bank of California,0,0,0,1,1
The State of Florida,0,2,0,4,6
The Timken Company,0,1,0,0,1
The University of Chicago,0,0,0,2,2
The University of Iowa,0,0,0,3,3
The University of Pittsburgh,0,0,1,0,1
The University of Texas Health Science Center at Houston (UTHealth),0,0,0,2,2
The University of TN Health Science Center,0,0,0,1,1
The Washington Post,0,0,1,1,2
The World Bank Group,0,0,0,1,1
Thermo Fisher Scientific,0,3,3,8,14
Thomson Reuters,0,0,0,2,2
THORLABS INC,0,0,1,0,1
TIBCO Software,0,1,0,0,1
Ticketmaster,0,0,1,3,4
TKC Holdings,0,1,0,0,1
T-Mobile,0,0,0,2,2
Toll Brothers,0,1,0,0,1
"Torch Technologies, Inc.",0,0,1,0,1
Total Technology Inc,0,0,1,0,1
Toxikon Corporation,0,0,0,1,1
TPC Group,0,0,1,0,1
TracFone Wireless,0,1,0,0,1
Transamerica,0,0,1,0,1
TransCanada,0,1,0,0,1
"Transcendia, INC.",0,1,0,0,1
"Transportation, Department of",0,0,1,0,1
Travelers,0,1,0,1,2
Travelport,0,0,0,1,1
TRAX Test Services,0,0,3,0,3
TRC,0,0,0,2,2
TRC Companies Inc,0,0,1,0,1
Trend Micro,0,0,1,0,1
"T-Rex Solutions, LLC.",0,1,0,0,1
Trimble,0,0,1,0,1
Trimble Inc.,0,0,0,1,1
TripAdvisor,0,0,1,0,1
TRPA,0,1,0,0,1
TSYS,0,0,1,0,1
TT Electronics,0,0,1,0,1
TTL,0,0,0,1,1
TubeScience,0,0,0,1,1
TUFTS University,0,1,0,1,2
TULK llc,0,0,2,0,2
Turbocam International,0,1,0,0,1
Twentieth Century Fox,0,1,0,0,1
"Two Sigma Investments, LLC.",0,0,1,2,3
"Tyler Technologies, Inc.",0,1,0,0,1
UC San Diego,0,1,0,1,2
UCAR,0,0,0,1,1
UCLA,0,1,0,2,3
Ultra Electronics Herley,0,0,1,0,1
UNC Charlotte,0,0,1,1,2
UNC-Chapel Hill,0,3,0,13,16
"UNCOMN, LLC",0,1,1,1,3
"Under Armour, Inc.",0,1,0,0,1
UNFI,0,1,1,0,2
UNICEF,0,1,0,1,2
Union Bank,0,1,0,0,1
UnionBank,0,1,0,0,1
Unisys,0,1,0,0,1
United Airlines Inc.,0,3,1,2,6
United Nations Development Programme (UNDP),0,0,0,1,1
UNITED PARCEL SERVICE,0,1,0,0,1
UnitedHealth Group,0,21,1,12,34
Univers,0,0,0,2,2
Universal Engineering Sciences,0,0,0,1,1
University at Buffalo,0,0,0,1,1
University Health Partners of Hawaii,0,0,0,1,1
University of Alaska,0,1,1,1,3
University of Arizona,0,0,0,3,3
University of Arkansas,0,1,0,0,1
University of California San Francisco Medical Center,0,1,0,1,2
"University of California, Santa Barbara",0,2,0,0,2
"University of California, Santa Cruz",0,1,0,1,2
University of Colorado,0,1,0,3,4
University of Florida,0,1,0,5,6
University of Hawaii,0,0,0,1,1
University of Illinois,0,0,1,2,3
University of Maryland Medical System,0,0,0,1,1
University of Massachusetts Medical School,0,0,0,1,1
University of Miami,0,0,0,1,1
University of Michigan,0,1,0,2,3
University of Nebraska Medical Center,0,0,0,2,2
University of Rochester,0,1,0,1,2
University of South Florida,0,0,0,1,1
University of Tennessee,0,0,1,1,2
University of Texas at Austin,0,0,0,1,1
University of Utah,0,1,0,1,2
University of Utah Health Care,0,0,0,1,1
University of Washington,0,1,1,3,5
University of Wisconsin - Stout,0,0,0,1,1
University of Wisconsin System,0,0,0,1,1
University of Wisconsin–Madison,0,1,0,2,3
University of Wyoming,0,2,1,1,4
Univest Financial Corporation,0,0,0,2,2
Unum,0,0,1,0,1
UPMC,0,0,0,1,1
Urban Health Collaborative- Drexel University,0,0,0,1,1
Urban Science,0,1,0,1,2
US Digital Partners,0,1,0,0,1
US General Services Administration,0,0,1,0,1
US Legislative Branch,0,0,1,0,1
US National Aeronautics and Space Administration,0,0,0,2,2
US Pharmacopeia,0,0,0,2,2
USAA,0,1,1,1,3
UT Health Science Center at San Antonio,0,1,0,3,4
UT Southwestern Medical Center,0,1,0,0,1
Utah Valley University,0,1,0,0,1
UTC,0,0,5,1,6
UTMB,0,0,0,1,1
VA Commonwealth Univ,0,1,0,1,2
"Vadata, Inc.",0,0,1,0,1
Valero Energy Corporation,0,0,1,0,1
Valley Children's Healthcare,0,1,0,0,1
Van Andel Institute,0,0,0,1,1
Vanderbilt University Medical Center,0,1,0,5,6
Vanguard,0,1,1,2,4
"Vanir Construction Management, Inc.",0,0,1,0,1
Vankirk Electric,0,2,0,0,2
Vantiv,0,1,0,0,1
Varo Money,0,1,1,1,3
VCU Health System,0,1,0,0,1
Veeva,0,1,0,0,1
Veolia US,0,0,3,0,3
Verana Health,0,0,0,1,1
Vericel,0,1,0,0,1
Verra Mobility,0,0,0,2,2
VERSALUS HEALTH,0,2,0,1,3
Vertex Pharmaceuticals,0,0,0,2,2
"Via Christi Health, KS",0,0,0,1,1
Vidoori inc,0,0,1,0,1
"Vigilant Technology Solutions, LLC",0,0,1,1,2
"Vijon, Inc",0,1,0,0,1
Viome,0,0,0,1,1
VirBela,0,0,2,1,3
Virgin Pulse,0,0,2,0,2
Virginia Commonwealth University,0,1,0,1,2
Virginia Department of Alcoholic Beverage Control,0,1,0,0,1
Virginia Mason Medical Center,0,1,0,0,1
Virginia Tech,0,0,1,0,1
Virginia Transportation Corp,0,0,0,1,1
Virtru,0,0,0,1,1
Virtus Partners,0,1,0,0,1
Vision Group Holdings,0,1,0,0,1
Vistana Signature Experiences,0,1,0,0,1
Vitamin World,0,1,0,0,1
Vitro,0,0,1,0,1
Vizio Inc.,0,0,0,1,1
VROOM,0,1,2,0,3
VSC PR,0,0,0,1,1
W. L. Gore & Associates,0,0,0,3,3
Wake County Government,0,2,0,3,5
Wake Forest Baptist Medical Center,0,1,0,1,2
Wake Technical Community College,0,0,1,0,1
WALGREENS,0,2,0,0,2
Walworth County,0,0,1,0,1
Warrant Technologies,0,0,1,0,1
"Washington County, OR",0,1,0,1,2
Washington State Patrol,0,0,0,2,2
Waste Management,0,2,0,0,2
"Watermark Risk Management International, LLC",0,0,0,1,1
Waters Corporation,0,0,0,2,2
Watts Water Technologies,0,0,0,1,1
Wawa,0,0,0,1,1
Wayfair,0,0,1,2,3
Wedbush Securities,0,0,0,1,1
Weill Cornell Medicine,0,0,0,4,4
WellCare,0,1,0,0,1
Wesco International,0,1,0,0,1
Western Alliance Bank,0,0,1,1,2
Western Connecticut Health Network,0,1,0,1,2
Western Digital,0,0,2,0,2
Western Governors University,0,2,1,2,5
Western National Insurance Group,0,1,0,0,1
Western Sky Community Care,0,1,0,0,1
Westfield Corporation,0,1,0,0,1
Westfield Insurance,0,0,0,1,1
WestRock,0,0,1,0,1
WeWork,0,0,1,1,2
Weyerhaeuser,0,0,0,1,1
Whirlpool Corporation,0,0,0,1,1
WhiteCanyon Software,0,0,1,0,1
Wifey Beauty LLC,0,0,0,1,1
Wilbur-Ellis Company,0,1,0,0,1
Wilmington Trust,0,1,0,0,1
Wilson Sporting Goods,0,0,0,1,1
Wipro,0,0,0,1,1
Wipro LTD,0,1,2,0,3
Wisconsin Department of Health Services,0,1,0,0,1
WK Dickson,0,0,0,1,1
"Woongjin, Inc",0,1,1,1,3
Workplace Alaska,0,2,0,0,2
WSFS Bank,0,0,1,0,1
Xcalar,0,0,0,1,1
Xcel Energy,0,0,1,0,1
Xellia,0,0,0,1,1
Xellia Pharmaceuticals,0,0,0,1,1
Xenon Ventures,0,1,0,0,1
Xilinx,0,0,1,0,1
XPO Logistics,0,3,0,1,4
Xylem,0,0,1,0,1
YAI,0,0,1,0,1
YAM Worldwide,0,0,0,1,1
"Yardi Systems, Inc.",0,1,0,0,1
Yazaki,0,0,1,0,1
YETI Coolers,0,1,0,0,1
Yodlee,0,0,1,0,1
Zachary Piper Solutions,0,1,0,0,1
Zebra Technologies,0,0,1,0,1
Zillow Group,0,0,4,6,10
Zimmer Biomet,0,0,1,0,1
Zin Technologies,0,0,0,7,7
"ZixCorp Systems, Inc.",0,2,0,0,2
ZS Associates,0,0,0,1,1
(blank),0,1,0,4,5
Accenture,1,13,1,0,14
Adobe,1,0,2,0,2
Amazon Services LLC,1,0,0,1,1
"Amazon Web Services, Inc.",1,0,6,17,23
"Amazon.com Services, Inc.",1,9,37,43,89
AT&T,1,1,3,2,6
Bank of America,1,10,0,1,11
Bayer,1,0,0,2,2
Bloomberg,1,0,0,1,1
Boston University,1,0,0,1,1
Capgemini,1,1,0,1,2
Cloudera,1,1,1,0,2
Coca Cola Bottling Co. Consolidated,1,0,0,1,1
Columbia University,1,0,0,4,4
Cornell University,1,0,0,1,1
DELL,1,2,4,1,7
Deloitte,1,0,1,7,8
Disney ABC Television Group,1,1,0,0,1
Disney Streaming Services,1,0,0,2,2
Facebook,1,0,0,2,2
Fiserv,1,2,1,0,3
"Fiserv, Inc.",1,0,0,1,1
Gartner,1,1,0,0,1
GlaxoSmithKline,1,0,0,1,1
Google,1,3,2,7,12
Harvard University,1,1,0,1,2
Hewlett Packard Enterprise,1,0,0,1,1
HP,1,0,1,1,2
IBM,1,3,8,8,19
Institute for Health Metrics and Evaluation - Faculty,1,1,0,1,2
Intel,1,2,15,10,27
KPMG,1,0,4,0,4
Microsoft,1,0,13,18,31
Nielsen,1,5,0,0,5
OpenText,1,1,0,0,1
Oracle,1,1,1,1,3
PepsiCo,1,0,1,3,4
Pfizer,1,0,0,2,2
Pfizer Inc.,1,0,0,6,6
Princeton University,1,0,1,2,3
Siemens,1,0,2,3,5
Stanford University,1,0,0,3,3
T-Mobile,1,5,9,4,18
Toyota,1,2,0,1,3
Twitter,1,0,1,0,1
U.S. Bank,1,0,1,0,1
U.S. Federal Government,1,0,0,4,4
UCLA Health,1,1,1,2,4
US Department of Commerce,1,0,1,1,2
US Department of Defense,1,2,3,1,6
US Department of Education,1,1,0,1,2
US Department of Energy,1,0,1,0,1
US Department of Health And Human Services,1,0,0,2,2
US Department of Homeland Security,1,1,0,0,1
US Department of Justice,1,0,0,2,2
US Department of Labor,1,0,0,2,2
US Department of State,1,0,1,0,1
US Department of the Air Force,1,2,2,2,6
US Department of the Army,1,0,1,2,3
US Department of the Interior,1,0,0,1,1
US Department of the Navy,1,1,4,4,9
US Department of Transportation,1,0,3,0,3
US Department of Veterans Affairs,1,1,0,2,3
VeriSign,1,1,0,0,1
Verizon,1,4,8,4,16
Visa,1,2,0,1,3
VMware,1,1,2,3,6
Walmart eCommerce,1,0,3,3,6
Walmart Stores,1,0,3,2,5
Wells Fargo,1,4,2,0,6
